4 6 8224 8247 8258 6707 3526 2075 
4 3 4631 5159 9182 
4 8 9182 9148 3317 1613 2380 8991 5046 8974 
4 4 4226 6667 1851 4180 
4 8 4180 5644 4724 5331 4537 1715 4291 8485 
4 4 8485 8457 3100 3197 
4 6 5120 984 7986 7928 6696 6511 
4 4 6511 4519 2143 7695 
4 4 7695 5242 510 2618 
4 6 2618 5130 5944 7391 5756 7354 
4 4 7354 502 7321 7308 
4 3 7308 925 6074 
4 3 6074 5453 7264 
4 3 7264 2568 3602 
4 7 3602 4284 1046 5499 4807 7173 7179 
4 7 7179 1575 6541 3894 4002 3913 6269 
4 7 2903 4679 7094 7101 7109 7117 6269 
4 8 2075 8236 6548 8215 4876 649 8118 5120 
4 9 5120 2199 6801 5146 4855 8029 7977 2981 3660 
2 7 649 8146 8113 5962 6166 8172 5692 
2 2 8224 5692 
4 11 3197 2274 3015 8306 3797 8256 8235 5786 2293 6833 5120 
3 4 8422 5351 3480 6790 
3 9 6790 123 1463 8829 5969 657 8913 5848 6737 
2 2 6221 8422 
3 4 8422 5336 8368 3526 
3 5 4180 230 5781 5220 6790 
2 7 8422 4698 2149 3017 8509 3728 8485 
3 15 6583 8741 6449 8780 8807 989 4025 8865 6603 8895 8925 8944 8954 5820 5046 
4 8 4226 3720 6810 6737 8934 8965 5548 8974 
2 3 8954 2441 2990 
3 6 9182 9167 9149 1001 3478 9155 
3 6 2380 9051 2645 6263 4487 9044 
3 7 9268 9273 6434 5581 9255 5559 4631 
